................................
................................
................................
.............cd..............cd.
................................
................................
.S.....E........................
...........#.............##.....
......###........###............
................................
---------~~---------~~~~~~~-----
________________________________