................................
................................
................................
.............cd..............cd.
................................
................................
................................
...........#.............##.....
.S....###........###............
................................
---------~~---------~~~~~~~-----
________________________________